type octile
height 8
width 8
map
AAAAAAAA
BAAAAAAA
BAAAAAAA
CAAAAAAA
BAAAAAAA
BAAAAAAA
BAAAAAAA
AAAAAAAA